R 720 500
NO ./files/images/textures/tile201.xpm
SO ./files/images/textures/tile202.xpm
WE   ./files/images/textures/tile203.xpm
EA  ./files/images/textures/tile204.xpm
S ./files/images/textures/tile205.xpm
TX1 ./files/images/textures/tile255.xpm
TX2 ./files/images/textures/tile254.xpm
C    20, 100,  202
F    20,40,20

11111111111111111111111111111
10000000001111100000000000001
10110000011110100020000010001
1011000000000000000000010001
10110000011100000000000010001
10000000001100000111011110001
11110111111111011100000010001
11110111111111011101010010001
11000000110101011100000010001
10002000000000001100000010001
1000000000000N001101010010001
11000111110101011111011110001
11110111111101011111011110001
11111111111111111111111111111
