R 0 20
NO ./files/images/textures/tile220.xpm
SO ./files/images/textures/tile221.xpm
WE   ./files/images/textures/tile223.xpm
EA  ./files/images/textures/tile229.xpm
S ./files/images/sprites/slugma.xpm
FT ./files/images/textures/tile230.xpm
CT ./files/images/textures/tile231.xpm

111111
100011
1S0001
111111
