R 720 500
NO ./files/images/textures/tile213.xpm
SO ./files/images/textures/tile249.xpm
WE   ./files/images/textures/tile255.xpm
EA  ./files/images/textures/tile248.xpm
S1 ./files/images/sprites/slugma.xpm
S2 ./files/images/textures/tile240.xpm
FT ./files/images/textures/tile198.xpm
CT ./files/images/textures/tile199.xpm
TX1     ./files/images/textures/tile202.xpm
TX2    ./files/images/textures/tile203.xpm


11111111111111111111111111111
10000000001111343052525003411
1011000001111010000000010001
10110000000000000E00000410011
10110000011400000000011000111
1000000000110000011111110001
11110111111111011100000010001
11110111111111011101010010001
11000000110101011100000010001
10002000000002001100020010001
100200000050000011010100100011
110000111110101011111011110001
11110111111101011111011110001
11111111111111111111111111111
