R 1920 1080

NO       ./textures/paper.xpm
SO ./textures/paper_dark.xpm
WE ./textures/paper_blue.xpm
EA     ./textures/paper_grey.xpm

S ./textures/Sprites/barrel.xpm

F 10,     100, 39
C    152, 198, 227


1111111111111
11001002001111
11110000100011
11000E00000011
11110002001111
10000000000111
111111101111
11111111100001
1111111111111
 

