R 920 700
NO  ./files/images/textures/tile222.xpm
SO ./files/images/textures/tile206.xpm
WE ./files/images/textures/tile207.xpm
EA      ./files/images/textures/tile208.xpm
S           ./files/images/sprites/slugma.xpm

F 244, 232, 32 
C  23, 232, 12


11111111111111111
11001000001111111
111100001001  101
11000E10000011111
11110000001111111
10000002000111
11111110111111
11111111100001
11111111111111
 

