R 920 500
NO  ./files/images/textures/tile222.xpm
SO ./files/images/textures/tile206.xpm
WE ./files/images/textures/tile207.xpm
EA      ./files/images/textures/tile208.xpm

S           ./files/images/sprites/slugma.xpm

F 	  10,  100, 39
C         152, 198, 227


11111111111111111
11001002001111111
111100001001  101
11000E00000011111
11110002001111111
10000000000111
11111110111111
11111111100001
11111111111111
 

