R  1920 1080
NO ./src/Meme1.png
SO ./src/Meme2.png
WE ./src/Meme3.png
EA ./src/Meme4.png
S ./src/Meme5.png
F 220,100,0
C 225,30,0

111111111111111111
1001100000000000011111111
1011000001110000002000001
11010000000000000000000011111111111
11111111111011000001110000000000001
   11100000000011000N01110111111111
11110111111111011100000010001
111101111111110111010100100011
110000001   1010111000000100011
1000000011111000001100000010001
1000000000000000110101001000111
11000001110101011111011110111
11110111 1110101 101111010001
11111111 1111111 1111111111011111111
                         100000000111111
                         111000000000001
                         100000000000001
                         100000000000001
                         111111111111111
