R 860 480
NO ./files/images/textures/tile234.xpm
SO ./files/images/textures/tile234.xpm
WE ./files/images/textures/tile234.xpm
EA ./files/images/textures/tile234.xpm

S ./files/images/sprites/slugma.xpm
F 10, 10, 100
C 152, 98, 27

1111111111
1000000001
1000000001
1000020001
1000000001
100N000001
1000000001
1111111111
